____________________________________________
|------------------------------------------|
|------------------------------------------|
|------------------------------------------|
|------------------------------------------|
|------------------------------------------|
|------------------------------------------|
|------------------------------------------|
|------------------B-----------------------|
|------------------------------------------|
|------------------------------------------|
******----************************----******
|------------------------------------------|
|------------------------------------------|
|------------------M-----------------------|
|------------------------------------------|
|------------------------------------------|
******----************************----******
|------------------------------------------|
|------------------------------------------|
|------------------M-----------------------|
|------------------------------------------|
|------------------------------------------|
******----************************----******
|------------------------------------------|
|------------------------------------------|
|------------------------------------------|
|--H---------------------------------------|
|------------------------------------------|
********************************************